- - - - - - - - - - - - -
- - - - - - - - - - - - -
- - - - - - - - - - - - -
- - - - - - - - - - - - -
- - 1 2 3 - - - 1 2 3 - -
- - - - - - - - - - - - -
- - - - - - - - - - - 4 5
- - - - - - - - - - - 6 7
- - - - - - - - - - - - -
- - - - - - - - - - - - -
- - - - - - - - - - - - -
- - - - - - - - - - - - -
- - 1 2 3 - - - 1 2 3 - -
- - - - - - - - - - - - -
8 9 - - - - - - - - - 8 9
8 9 - - - - - - - - - 8 9